__________
___c______
____c_____
_____c____
__________